####################
####################
###-----------######
S---#########------E
####################
####################
####################
####################
####################
