####################
S--#######------####
##-#######-####-####
##-#######-####-####
##---#####-####-####
####-##----####-####
####-##-#######-####
####----#######----E
####################
