####################
##--------------####
##-############-####
##-############-####
##--------#####-####
#########-#####-####
#########-#####----E
S---------##########
####################
